SBOOOBOOOBOOO
OBOBOBOBOBOBO
OBOBOBOBOBOBO
OBOBOBOBOBOBO
OBOBOBOBOBOBO
OBOBOBOBOBOBO
OOOBOOOBOBOBF