BBBBBBBBBBBBBBBBBBBBBBBBBBBBBBBBBBBBBBBBBBBBBBBBBB
BBBBBBBBBBBBBBBBBBBBBBBBBBBBBBBBBBBBBBBBBBBBBBBBBB
BBBBBBBBBBBBBBBBBBBBBOOOOOOOOOOBBBBBBBBBBBBBBBBBBB
BBBBBBBBBBBBBBBBBOOOOOOOOOOOOOOOOOBBBBBBBBBBBBBBBB
BBBBBBBBBBBBBBBOOOOBBBBBBBBBBBBBOOOOBBBBBBBBBBBBBB
BBBBBBBBBBBBBOOOBBBBBOOOOOOOBBBBBBBOOOBBBBBBBBBBBB
BBBBBBBBBBBOOOBBBOOOOOOOOOOOOOOOBBBBBOOBBBBBBBBBBB
BBBBBBBBBBOOOBBBOOOBBBBBBBBBBBOOOOBBBBOOBBBBBBBBBB
BBBBBBBBBOOBBBOOOBBBBBBBBBBBBBBBBOOBBBBOOBBBBBBBBB
BBBBBBBBOOBBBOOBBBBBOOOOOOOOOBBBBBOOOBBBOOBBBBBBBB
BBBBBBBOOBBBOOBBBBBOOBBBBBBBBBBOOBBBOOBBBOOBBBBBBB
BBBBBBOOBBBOOBBBBBBBBBBBBBBBBBOOOOBBBOOBBBOOBBBBBB
BBBBBBOOBBOOBBBOOBBBBBOOOOOOBBOBBOOOBBOOBBOOBBBBBB
BBBBBOOBBOOBBBOOOOBBBOOOBBBOOOOBBBBOOBBOOBBOOBBBBB
BBBBBOOBBOOBBOOBBOBBBBOBBBBBBBOOBBBBOOBBOBBBOOBBBB
BBBBOOBBOOBBOOBBBOBBBBOOOOOOBBBOOBBBBOBBOOBBOOBBBB
BBBBOOBBOBBBOBBBOOBBBBBBBBOOOOBBOOBBBOOBBOBBOOBBBB
BBBBOOOBBBBOOBBOOBBOBBBBBBBBBOOBBOOBBBOBBOOBBOOBBB
BBBOOBOOBBOOBBOOBBOOBBBBBBBBBBOOBBOOBBOOBBOBBOOBBB
BBBOOBOOBBOBBBOBBOOBBBBBOOBBBBBOOBBOOBBOBBOOBBOBBB
BBBOOBOBBBOBBOOBBOOOBBBOOOOBBBBOOOBBOBBOOBOOBBOBBB
BBBOBBOBBOOBBOBBOOBOOBBOOOOBBOOOBOBBOBBBOBOOBBOOBB
BBBOBBOBBOOBOOBBOBBBOOBBOOBBOOOBBOOBOOBBOBOOBBOOBB
BBOOBBOBBOBBOOOOOBBBBOOBOOBOOBBBBBBBBOOOOBBOOBOOBB
BBOOBBOBOOBBOOOOBBBBBBOOOOOOBBBBBBBBBOOBOOBOOBOOBB
BBOOBOOBOOBBBBBBBBBBBBBOOOOBBBBBBBBBBOOBOOBOOBOOBB
BBOOBOOBOOBBBBOOOOOOBBBOOOOBOOOOOOOBBOOBOOBOOBOOBB
BBOOBOOBOOBBOOOOBBBOBBBOOOOBOOBBBBOBBOOBOOBOOBOOBB
BBOOBBOBBOBBOBBBBBBOBBBOOOOBOOOBBBOBBOOBOOBOOBOOBB
BBBOBBOBBOBBOOBBBOOOBBBOOOOBBBOOBBOBBOBBOBBOBBOBBB
BBBOBBOBBOBBOOBBOOOBBBOOBBOOBBBBBOOBBOBBOBBOOBOBBB
BBBOBBOOBOOBOOBBOBBBBOOBBBBBOOBBBOBBBOBOOBBOOOOBBB
BBBOOBOOBBOBBOBBOOBBOOBBOOBBBOOBBOBBOOBOOBOOBOOBBB
BBBOOBBOBBOOBOBBOOBOOBBOOOOBBBOOOOBOOBBOBBOOBOOBBB
BBBBOBBOOBOOBOOBBOOOBBOOBBOOBBBOOBBOOBOOBBOBBOBBBB
BBBBOOBOOBBOBBOBBBOOBBOOBBOOBBBOBBOOBBOBBOOBOOBBBB
BBBBOOBBOOBOOBOOBBOOBBBOOOOBBBOOBBOBBOOBOOBBOOBBBB
BBBBBOBBOOBBOBBOOBBOOBBBOOBBBOOBBOOBBOBBOBBOOBBBBB
BBBBBOOBBOOBOOBBOBBBOBBBBBBBOOBBOOBBOOBBOBBOBBBBBB
BBBBBBOOBBOBBOOBBOBBOOBBBBBOOBBOOBBOOBBBBBOOBBBBBB
BBBBBBOOBBOOBBOOBOOBBOOBBBOOBBOOBBOOBBOBBOOBBBBBBB
BBBBBBBOOBBOOBBFBBOOBBOOBBOBBOOBBOOBBOOBOOBBBBBBBB
BBBBBBBBOOBBOOBBBBOOBBOOBBBBOOBBOOBBOOBBOBBBBBBBBB
BBBBBBBBBOOBBOOBBOBBBOOBBBBBOOBBOOBOOBBOOBBBBBBBBB
BBBBBBBBBBOOBBOOOOBBOOBBBBBBBOOBBOOOBBOOBBBBBBBBBB
BBBBBBBBBBOOBBOOBBOOBBBBOBBBBOBBBOBBOOOBBBBBBBBBBB
BBBBBBBBBBBOOBBBBOOBBBBOOOBBBOOBBBBOOBBBBBBBBBBBBB
BBBBBBBBBBBBSOOBOOBBBBOOBOOBBBOOBBOOBBBBBBBBBBBBBB
BBBBBBBBBBBBBBOOOBBBBOOBBBOOBBBOOOOBBBBBBBBBBBBBBB
BBBBBBBBBBBBBBBOOBBBOOBBBBBOOBBBOBBBBBBBBBBBBBBBBB
BBBBBBBBBBBBBBBBBBBBOOOOOOOOOBBBBBBBBBBBBBBBBBBBBB