BBBBBBBBBBBBBBBBBBBBBBBBBBBBBBBBBBBBBBBBBBBBBBBBBB
BBBBBBBBBBBBBBBBBBBBBBBBBBBBBBBBBBBBBBBBBBBBBBBBBB
BBBBBBBBBBBBBBBBBBBBBOOOOOOOOOOBBBBBBBBBBBBBBBBBBB
BBBBBBBBBBBBBBBBBOOOOOOOOOOOOOOOOOBBBBBBBBBBBBBBBB
BBBBBBBBBBBBBBBOOOOBBBBBBBBBBBBBOOOOBBBBBBBBBBBBBB
BBBBBBBBBBBBBOOOBBBBBOOOOOOOBBBBBBBOOOBBBBBBBBBBBB
BBBBBBBBBBBOOOBBBOOOOOOOOOOOOOOOBBBBBOOBBBBBBBBBBB
BBBBBBBBBBOOOBBBOOOBBBBBBBBBBBOOOOBBBBOOBBBBBBBBBB
BBBBBBBBBOOBBBOOOBBBBBBBBBBBBBBBBOOBBBBOOBBBBBBBBB
BBBBBBBBOOBBBOOBBBBBOOOOOOOOOBBBBBOOOBBBOOBBBBBBBB
BBBBBBBOOBBBOOBBBBBOOBBBBBBBBBBOOBBBOOBBBOOBBBBBBB
BBBBBBOOBBBOOBBBBBBBBBBBBBBBBBOOOOBBBOOBBBOOBBBBBB
BBBBBBOOBBOOBBBOOBBBBBOOOOOOBBOBBOOOBBOOBBOOBBBBBB
BBBBBOOBBOOBBBOOOOBBBOOOBBBOOOOBBBBOOBBOOBBOOBBBBB
BBBBBOOBBOOBBOOBBOBBBBOBBBBBBBOOBBBBOOBBOBBBOOBBBB
BBBBOOBBOOBBOOBBBOBBBBOOOOOOBBBOOBBBBOBBOOBBOOBBBB
BBBBOOBBOBBBOBBBOOBBBBBBBBOOOOBBBOBBBOOBBOBBOFBBBB
BBBBOOOBBBBOBBBOOBBOBBBBBBBBBOOBBOOBBBOBBOOBBOOBBB
BBBOOBOOBBOOBBOOBBOOBBBBBBBBBBOOBBOOBBOOBBOBBOOBBB
BBBOOBOOBBOBBBOBBOOBBBBBOOBBBBBOOBBOOBBOBBOOBBOBBB
BBBOOBOBBBOBBOOBBOOOBBBOOOOBBBBOOOBBOBBOOBOOBBOBBB
BBBOBBOBBOOBBOBBOOBOOBBOOOOBBOOOBOBBOBBBOBOOBBOOBB
BBBOBBOBBOOBOOBBOBBBOOBBOOBBOOOBBOOBOOBBOBOOBBOOBB
BBOOBBOBBOBBOOOOOBBBBOOBOOBOOBBBBBBBBOOOOBBOOBOOBB
BBOOBBOBOOBBOOOOBBBBBBBOOOOOBBBBBBBBBOOBOOBOOBOOBB
BBOOBOOBOOBBBBBBBBBBBBBOOOOBBBBBBBBBBOOBOOBOOBOOBB
BBOOBOOBOOBBBBOOOOOOBBBOOOOBOOOOOOOBBOOBOOBOOBOOBB
BBOOBOOBOOBBOOOOBBBOBBBOOOOBOOBBBBOBBOOBOOBOOBOOBB
BBOOBBOBBOBBOBBBBBBOBBBOOOOBOOOBBBOBBOOBOOBOOBOOBB
BBBOBBOBBOBBOOBBBOOOBBBOOOOBBBOOBBOBBOBBOBBOBBOBBB
BBBOBBOBBOBBOOBBOOOBBBOOBBOOBBBBBOOBBOBBOBBOOBOBBB
BBBOBBOOBOOBOOBBOBBBBOOBBBBBOOBBBOBBBOBOOBBOOOOBBB
BBBOOBOOBBOBBOBBOOBBOOBBOOBBBOOBBOBBOBBOOBOOBOOBBB
BBBOOBBOBBOOBOBBOOBOOBBOOOOBBBOOOOBOOBBOBBOOBOOBBB
BBBBOBBOOBOOBOOBBOOOBBOOBBOOBBBOOBBOOBOOBBOBBOBBBB
BBBBOOBOOBBOBBOBBBOOBBOOBBOOBBBOBBOOBBOBBOOBOOBBBB
BBBBOOBBOOBOOBOOBBOOBBBOOOOBBBOOBBOBBOOBOOBBOOBBBB
BBBBBOBBOOBBOBBOOBBOOBBBOOBBBOOBBOBBBOBBOBBOOBBBBB
BBBBBOOBBOOBOOBBOBBBOBBBBBBBOOBBOOBBOOBBOBBOBBBBBB
BBBBBBOOBBOBBOOBBOBBOOBBBBBOOBBOOBBOOBBBBBOOBBBBBB
BBBBBBOOBBOOBBOOBOOBBOOBBBOOBBOOBBOOBBOBBOOBBBBBBB
BBBBBBBOOBBOOBBOBBOOBBOOBBOBBOOBBOOBBOOBOOBBBBBBBB
BBBBBBBBOOBBOOBBBBOOBBOOBBBBOOBBOOBBOOBBOBBBBBBBBB
BBBBBBBBBOOBBOOBBOBBBOOBBBBBOOBBOOBOOBBOBBBBBBBBBB
BBBBBBBBBBOOBBOOOOBBOOBBBBBBBOOBBOOOBBOOBBBBBBBBBB
BBBBBBBBBBOOBBOOBBOOBBBBOBBBBOBBBOBBOOBBBBBBBBBBBB
BBBBBBBBBBBOOBBBBOOBBBBOOOBBBOOBBBBOOBBBBBBBBBBBBB
BBBBBBBBBBBBSOOBOOBBBBOOBOOBBBOOBBOOBBBBBBBBBBBBBB
BBBBBBBBBBBBBBOOOBBBBOOBBBOOBBBOOOBBBBBBBBBBBBBBBB
BBBBBBBBBBBBBBBOOBBBOOBBBBBOOBBBOBBBBBBBBBBBBBBBBB
BBBBBBBBBBBBBBBBBBBBOOOOOOOOOBBBBBBBBBBBBBBBBBBBBB